가막살나무 - 죽음보다 강한 사랑
가문비나무 - 성실, 정직
가시박 - 기다림
가지 - 진실
각시투구꽃 - 용사의 모자
갈대 - 신의, 믿음, 지혜
감나무 - 경의, 자애, 소박
감자 - 당신을 따르겠습니다
갓 - 무관심
강아지풀 - 동심, 노여움
개나리 - 희망, 나의 사랑은 당신보다 깊습니다
개별꽃 - 귀여움
개다래나무 - 꿈꾸는 심정
개망초 - 화해
개미취 - 기억, 추억, 먼 곳의 벗을 그리워하다
개벚지나무 - 시골 처녀
개암나무 - 화해, 잘 어울리는 한쌍
개양귀비 - 약한 사랑, 덧없는 사랑, 무관심, 냉담
개회나무 - 청춘의 추억
갯버들 - 친절, 자유
거베라 - 신비, 풀 수 없는 수수께끼
겨자 - 무관심
겨우살이 - 강한 인내심
계요등 - 지혜
고광나무 - 기품, 품격, 추억
고데마리 - 노력
고무나무 - 변함 없는 사랑, 영원한 행복
고사리 - 기적, 유혹
고추나무 - 한, 의혹, 미신
고추나물 - 친절
공작선인장 - 정열
괴불나무 - 사랑의 희열
공작초 - 항상 좋은 기분, 안부
과꽃 - 믿는 사랑, 추억
관음죽 - 행운
광나무 - 강인한 마음
구상나무 - 기개
구즈베리아 - 만족
구름패랭이꽃 - 위급
구골나무 - 보호, 용의
국화 - 정말 좋은 친구
하얀 국화 - 성실, 진실
노란 국화 - 실망, 짝사랑
빨간 국화 - 진실
국수나무 - 모정
군자란 - 고귀
굴거리나무 - 내 사랑 나의 품에
구기자나무 - 희생
궁궁이 - 고결
귀룽나무 - 사색
귤 - 마음의 스승
극락조화 - 사랑을 위해 멋을 부린 남자, 신비, 영구불멸
글라디올라스 - 밀회, 경계, 주의
글로리오사 - 광영, 영광
글록시니아 - 화려한 모습, 욕망
금관화 - 화려한 추억
금괭이눈 - 골짜기의 황금, 변하기 쉬운 마음
금귤 - 순결, 어릴 때 우정
금낭화 - 당신을 따르겠습니다.
금매화 - 꿈 많은 소녀
금목서 - 당신의 마음을 끌다.
금사슬나무 - 슬픈 아름다움
금어초 - 수다쟁이, 주제넘게 참견하다
금영화 - 희망, 부, 성공
금잔화 - 비탄, 실망, 비애, 겸손, 인내, 이별의 슬픔
금작화 - 청초
기린초 - 소녀의 사랑
기생꽃 - 천사
긴개싱아 - 백로다리
까치밥나무 - 풍요, 숨겨진 사랑
꽃사과 - 유혹
꽃다지 - 무관심
꽃생강 - 신뢰, 헛수고
꽃싸리 - 밀원
꽃잔디 - 희생
꽃쥐손이 - 새색시
꽃창포 - 우아한 마음, 좋은 소식
꽃향유 - 가을향기, 과거를 묻지 마세요
꽈리 - 거짓, 속임수
꽝꽝나무 - 참고 견디어 낼 줄 아는
그레빌레아 로부티스타 - 가련
그로키니시아 - 야심, 욕심